[console_scripts]
abandon = leytonium.abandon:main
afternet = leytonium.afternet:main
agi = leytonium.agi:main
agil = leytonium.agil:main
autokb = leytonium.autokb:main
autopull = leytonium.autopull:main
awslogs = leytonium.awslogs:main
bashrc = leytonium.bashrc:main
br = leytonium.br:main
brown = leytonium.brown:main
ci = leytonium.ci:main
co = leytonium.co:main
d = leytonium.d:main
diffuse = diffuse.diffuse:main
dp = leytonium.dp:main
drclean = leytonium.drclean:main
drop = leytonium.drop:main
drst = leytonium.drst:main
dup = leytonium.dup:main
dx = leytonium.dx:main
eb = leytonium.eb:main
encrypt = leytonium.encrypt:main
examine = leytonium.examine:main
extractaudio = leytonium.extractaudio:main
fetchall = leytonium.fetchall:main
fixemails = leytonium.fixemails:main
gag = leytonium.gag:main
gimports = leytonium.gimports:main
git-functions-path = leytonium.git_functions_path:main
gpgedit = leytonium.gpgedit:main
gt = leytonium.gt:main
halp = leytonium.halp:main
hgcommit = leytonium.hgcommit:main
imgdiff = leytonium.imgdiff:main
isotime = leytonium.isotime:main
ks = leytonium.ks:main
mdview = leytonium.mdview:main
multimerge = leytonium.multimerge:main
n = leytonium.n:main
ncswitch = leytonium.ncswitch:main
next = leytonium.next:main
pb = leytonium.pb:main
pd = leytonium.pd:main
pinswitch = leytonium.pinswitch:main
prepare = leytonium.prepare:main
publish = leytonium.publish:main
pullall = leytonium.pullall:main
pushall = leytonium.pushall:main
rd = leytonium.rd:main
rdx = leytonium.rdx:main
readjust = leytonium.readjust:main
reks = leytonium.reks:main
ren = leytonium.ren:main
resimp = leytonium.resimp:main
rol = leytonium.rol:main
rx = leytonium.rx:main
scrape85 = leytonium.scrape85:main
scrub = leytonium.scrub:main
setparent = leytonium.setparent:main
shove = leytonium.shove:main
show = leytonium.show:main
showstash = leytonium.showstash:main
slam = leytonium.slam:main
spamtrash = leytonium.spamtrash:main
splitpkgs = leytonium.splitpkgs:main
squash = leytonium.squash:main
st = leytonium.st:main
stacks = leytonium.stacks:main
stmulti = leytonium.stmulti:main
t = leytonium.t:main
tabsmode = leytonium.tabsmode:main
taskding = leytonium.taskding:main
terminator = leytonium.terminator:main
touchb = leytonium.touchb:main
unpub = leytonium.unpub:main
unslam = leytonium.unslam:main
upgrade = leytonium.upgrade:main
vcp = leytonium.vcp:main
vpn = leytonium.vpn:main
vunzip = leytonium.vunzip:main
watchdesk = leytonium.watchdesk:main
